This is a very alpha text adventure port of the MMO game Glitch.

Honestly there's nothing here yet, only a couple of empty rooms. This is acting as a stub so I can link from GitHub to here.

You can find the source for this on Github over here: https://github.com/revdancatt/cat428-glitch-text-adventure

text-glitch alpha version 0.2.2
An Interactive Fiction by Rev Dan Catt
Release 1 / Serial number 130101 / Inform 7 build 6G60 (I6/v6.32 lib 6/12N) SD

Anrasan Glance
You are in Anrasan Glance, Alakol. Ekorran Roughs is to the West, Getan Tenets is North West and Semsan Simile is East.

You can see a Produce Vendor, a shrine to Mab (empty), a Fruit Tree, a Bean Tree, nine metal rocks and four dullite rocks here.

>w
Ekorran Roughs
You are in Ekorran Roughs, Alakol.

* * *

>go Ekorran Roughs
You can't see any such thing.