==================================================

This is a very alpha text adventure port of the MMO game Glitch, it's currently mainly acting as a stub so I can link from GitHub to here.

Currently you can just about walk around Alakol with very little else to do.

You can find the source for this on Github over here: https://github.com/revdancatt/cat428-glitch-text-adventure

==================================================

text-glitch alpha version 0.2.4
An Interactive Fiction by Rev Dan Catt
Release 1 / Serial number 130103 / Inform 7 build 6G60 (I6/v6.32 lib 6/12N) SD

Anrasan Glance
You are in Anrasan Glance, Alakol. Ekorran Roughs is to the West, Getan Tenets is Northwest and Semsan Simile is East.

You can see a Produce Vendor, a shrine to Mab (empty), a Fruit Tree, a Bean Tree, nine metal rocks and four dullite rocks here.

>w
Ekorran Roughs
You are in Ekorran Roughs, Alakol. The clifftop trails lead off East and West to Anrasan Glance and Flogan Shames, Lustan Cautions is Northwest, a cave entrance to the North leads to Getan Tenets while a path down the cliff to the South leads to beach and Via Firozi.

>w
Flogan Shames
You are in Flogan Shames, Alakol.

>e
Ekorran Roughs
You are in Ekorran Roughs, Alakol. The clifftop trails lead off East and West to Anrasan Glance and Flogan Shames, Lustan Cautions is Northwest, a cave entrance to the North leads to Getan Tenets while a path down the cliff to the South leads to beach and Via Firozi.

>s
Via Firozi
You are in Via Firozi, Alakol.

>n
Ekorran Roughs
You are in Ekorran Roughs, Alakol. The clifftop trails lead off East and West to Anrasan Glance and Flogan Shames, Lustan Cautions is Northwest, a cave entrance to the North leads to Getan Tenets while a path down the cliff to the South leads to beach and Via Firozi.

>d
You can't go that way.

* * *

>w
Flogan Shames
You are in Flogan Shames, Alakol.

>nw
You can't go that way.

>w
You can't go that way.

>e
Ekorran Roughs
You are in Ekorran Roughs, Alakol.

>ne
Getan Tenets
You are in Getan Tenets, Alakol.

>nw
Anrasan Glance
You are in Anrasan Glance, Alakol. Ekorran Roughs is to the West, Getan Tenets is Northwest and Semsan Simile is East.

You can see a Produce Vendor, a shrine to Mab (empty), a Fruit Tree, a Bean Tree, nine metal rocks and four dullite rocks here.

>nw
Getan Tenets
You are in Getan Tenets, Alakol.

>nw
Anrasan Glance
You are in Anrasan Glance, Alakol. Ekorran Roughs is to the West, Getan Tenets is Northwest and Semsan Simile is East.

You can see a Produce Vendor, a shrine to Mab (empty), a Fruit Tree, a Bean Tree, nine metal rocks and four dullite rocks here.

* * *

>nw
Getan Tenets
You are in Getan Tenets, Alakol.

>se
Anrasan Glance
You are in Anrasan Glance, Alakol. Ekorran Roughs is to the West, Getan Tenets is Northwest and Semsan Simile is East.

You can see a Produce Vendor, a shrine to Mab (empty), a Fruit Tree, a Bean Tree, nine metal rocks and four dullite rocks here.

>se
Getan Tenets
You are in Getan Tenets, Alakol.

>se
Anrasan Glance
You are in Anrasan Glance, Alakol. Ekorran Roughs is to the West, Getan Tenets is Northwest and Semsan Simile is East.

You can see a Produce Vendor, a shrine to Mab (empty), a Fruit Tree, a Bean Tree, nine metal rocks and four dullite rocks here.

* * *

>w
Ekorran Roughs
You are in Ekorran Roughs, Alakol. The clifftop trails lead off East and West to Anrasan Glance and Flogan Shames, Lustan Cautions is Northwest, a cave entrance to the North leads to Getan Tenets while a path down the cliff to the South leads to beach and Via Firozi.

>exits
That's not a verb I recognise.

>look
Ekorran Roughs
You are in Ekorran Roughs, Alakol.

* * *

>w
Ekorran Roughs
You are in Ekorran Roughs, Alakol. The clifftop trails lead off East and West to Anrasan Glance and Flogan Shames, Lustan Cautions is Northwest, a cave entrance to the North leads to Getan Tenets while a path down the cliff to the South leads to beach and Via Firozi.

>e
Anrasan Glance
You are in Anrasan Glance, Alakol. Ekorran Roughs is to the West, Getan Tenets is Northwest and Semsan Simile is East.

You can see a Produce Vendor, a shrine to Mab (empty), a Fruit Tree, a Bean Tree, nine metal rocks and four dullite rocks here.

>e
You can't go that way.

* * *

>w
Ekorran Roughs
You are in Ekorran Roughs, Alakol. The clifftop trails lead off East and West to Anrasan Glance and Flogan Shames, Lustan Cautions is Northwest, a cave entrance to the North leads to Getan Tenets while a path down the cliff to the South leads to beach and Via Firozi.

>s
Via Firozi
You are in Via Firozi, Alakol.

>u
Ekorran Roughs
You are in Ekorran Roughs, Alakol. The clifftop trails lead off East and West to Anrasan Glance and Flogan Shames, Lustan Cautions is Northwest, a cave entrance to the North leads to Getan Tenets while a path down the cliff to the South leads to beach and Via Firozi.

>d
Via Firozi
You are in Via Firozi, Alakol.

>u
Ekorran Roughs
You are in Ekorran Roughs, Alakol. The clifftop trails lead off East and West to Anrasan Glance and Flogan Shames, Lustan Cautions is Northwest, a cave entrance to the North leads to Getan Tenets while a path down the cliff to the South leads to beach and Via Firozi.

* * *

>e
Semsan Simile
You are in Semsan Simile at the start (or end depending on your point of view) of the cliff top path which heads off into the distance Westwards. A rather intriguing exit leads East to Groddle Heights but an annoying magical force is preventing you from heading in that direction.

>w
Anrasan Glance
You are in Anrasan Glance, Alakol. Ekorran Roughs is to the West, Getan Tenets is Northwest and Semsan Simile is East.

You can see a Produce Vendor, a shrine to Mab (empty), a Fruit Tree, a Bean Tree, nine metal rocks and four dullite rocks here.

>w
Ekorran Roughs
You are in Ekorran Roughs, Alakol. The clifftop trails lead off East and West to Anrasan Glance and Flogan Shames, Lustan Cautions is Northwest, a cave entrance to the North leads to Getan Tenets while a path down the cliff to the South leads to beach and Via Firozi.

* * *

>e
Anrasan Glance
You are in Anrasan Glance, Alakol. Ekorran Roughs is to the West, Getan Tenets is Northwest and Semsan Simile is East.

You can see a Produce Vendor, a shrine to Mab (empty), a Fruit Tree, a Bean Tree, nine metal rocks and four dullite rocks here.

>nw
Getan Tenets
You are in Getan Tenets, Alakol.

* * *

>nw
Hammar Steadies
You are in Hammar Steadies, Alakol. The clifftop trails lead off North and Southeast to Smy Mod and Vindel Frowns, grassy paths head Northeast to Dyran Notion and East to Navran Dissent.

>n
Smy Mod
You are in Smy Mod at the end (or start depending on your point of view) of the cliff top path which heads off into the distance Southwards, although you can also head inland East to Dyran Notion.

>e
Dyran Notion
You are in Dyran Notion, Alakol. Marlan Bias and Navran Dissent are futher into the grassy plains to the North and Southeast, while Hammar Steadies and Smy Mod are along a rock path running Southwest and Westwards.

* * *

>w
Taftan Raves
You are in Taftan Raves, Alakol. The cliff top trails continues East and West to Flogan Shames and Vindel Frowns, Dofsan Vex is to the Northwest, a dark cave Northeast leasts to Simean Dims.

>ne
You can't go that way.

>nw
Dofsan Vex
You are in Dofsan Vex, Alakol.

>n
You can't go that way.

>ne
Isalan Interval
You are in Isalan Interval, Alakol.

>sw
Dofsan Vex
You are in Dofsan Vex, Alakol.

* * *

>nw
Getan Tenets
You are in Getan Tenets, underground in Alakol. You can exit to Anrasan Glance and Ekorran Roughs through a cave exit Southeast and Southwest. Other exits to the Northeast and West will take you to Stora Rede and Lustan Cautions.

>w
You can't go that way.

>e
You can't go that way.

>w
You can't go that way.

* * *

>nw
Getan Tenets
You are in Getan Tenets, underground in Alakol. You can exit to Anrasan Glance and Ekorran Roughs through a cave exit Southeast and Southwest. Other exits to the Northeast and West will take you to Stora Rede and Lustan Cautions.

>n
You can't go that way.

* * *

>ne
Stora Rede
You are in Stora Rede, Alakol. A rocky path leads to Yan Jaggery and Torpan Cleft to the Northeast and North, while in the opposite direction a grassy track heads South into the Lustan Cautions. Curiously the faint sound of foxes can be heard drifting in from the East.

Oh and cave! There's a cave to the Southeast.

>se
Getan Tenets
You are in Getan Tenets, underground in Alakol. You can exit to Anrasan Glance and Ekorran Roughs through a cave exit Southeast and Southwest. Other exits to the Northeast and West will take you to Stora Rede and Lustan Cautions.

* * *

>nw
Getan Tenets
You are in Getan Tenets, underground in Alakol. You can exit to Anrasan Glance and Ekorran Roughs through a cave exit Southeast and Southwest. Other exits to the Northeast and West will take you to Stora Rede and Lustan Cautions.

>nw
Stora Rede
You are in Stora Rede, Alakol.

* * *

>nw
Getan Tenets
You are in Getan Tenets, underground in Alakol. You can exit to Anrasan Glance and Ekorran Roughs through a cave exit Southeast and Southwest. Other exits to the Northeast and West will take you to Stora Rede and Lustan Cautions.

>ne
Stora Rede
You are in Stora Rede, Alakol.

>e
Kobah Habitat
You are in Kobah Habitat, Alakol.

>w
Stora Rede
You are in Stora Rede, Alakol.

>ne
Yan Jaggery
You are in Yan Jaggery, Alakol.

>n
Bolesan Ambitions
You are in Bolesan Ambitions, Alakol. A cave entrance leads the way Northeast to Motala Dun, while a rocky path leads Northwest to Harkan Idiom. Pinnan Glimpse is Southeast and Yan Jaggery is South.

>ne
Motala Dun
You are in Motala Dun, Alakol.

>sw
Bolesan Ambitions
You are in Bolesan Ambitions, Alakol. A cave entrance leads the way Northeast to Motala Dun, while a rocky path leads Northwest to Harkan Idiom. Pinnan Glimpse is Southeast and Yan Jaggery is South.

>nw
Harkan Idiom
You are in Harkan Idiom, Alakol.

>se
Bolesan Ambitions
You are in Bolesan Ambitions, Alakol. A cave entrance leads the way Northeast to Motala Dun, while a rocky path leads Northwest to Harkan Idiom. Pinnan Glimpse is Southeast and Yan Jaggery is South.

>se
Pinnan Glimpse
You are in Pinnan Glimpse, Alakol.

>nw
Bolesan Ambitions
You are in Bolesan Ambitions, Alakol. A cave entrance leads the way Northeast to Motala Dun, while a rocky path leads Northwest to Harkan Idiom. Pinnan Glimpse is Southeast and Yan Jaggery is South.

>s
Yan Jaggery
You are in Yan Jaggery, Alakol.

>n
Bolesan Ambitions
You are in Bolesan Ambitions, Alakol. A cave entrance leads the way Northeast to Motala Dun, while a rocky path leads Northwest to Harkan Idiom. Pinnan Glimpse is Southeast and Yan Jaggery is South.

* * *

>go Ekorran Roughs
You can't see any such thing.

>w
Ekorran Roughs
You are in Ekorran Roughs, Alakol.

>r
That's not a verb I recognise.

>e
Anrasan Glance
You are in Anrasan Glance, Alakol. Ekorran Roughs is to the West, Getan Tenets is North West and Semsan Simile is East.

You can see a Produce Vendor, a shrine to Mab (empty), a Fruit Tree, a Bean Tree, nine metal rocks and four dullite rocks here.

>e
You can't go that way.

>n
You can't go that way.

>u
You can't go that way.

>nw
You can't go that way.

>nnw
That's not a verb I recognise.

>nw
You can't go that way.

* * *

>se
You can't go that way.

>nw
You can't go that way.

>se
You can't go that way.