==================================================

This is a very alpha text adventure port of the MMO game Glitch, it's currently mainly acting as a stub so I can link from GitHub to here.

Currently you can just about walk around Alakol with very little else to do.

You can find the source for this on Github over here: https://github.com/revdancatt/cat428-glitch-text-adventure

==================================================

text-glitch alpha version 0.2.4
An Interactive Fiction by Rev Dan Catt
Release 1 / Serial number 130103 / Inform 7 build 6G60 (I6/v6.32 lib 6/12N) SD

Anrasan Glance
You are in Anrasan Glance, Alakol. Ekorran Roughs is to the West, Getan Tenets is Northwest and Semsan Simile is East.

You can see a Produce Vendor, a shrine to Mab (empty), a Fruit Tree, a Bean Tree, nine Metal Rocks and four Dullite Rocks here.

>x shrine
A shrine dedicated to a certain giant. All donations deposited into such a shrine will, through the gigantic grapevine, result in favour being paid to the donator. Shrines to the 11 Giants can be found throughout Ur.

>w
Ekorran Roughs
You are in Ekorran Roughs, Alakol. The clifftop trails lead off East and West to Anrasan Glance and Flogan Shames, Lustan Cautions is Northwest, a cave entrance to the North leads to Getan Tenets while a path down the cliff to the South leads to beach and Via Firozi.

>w
Flogan Shames
You are in Flogan Shames, Alakol. The cliff top trails lead off East and West to Ekorran Roughs and Taftan Raves, Lustan Cautions is to the Northeast, a dark cave Northwest leasts to Simean Dims.

>w
Taftan Raves
You are in Taftan Raves, Alakol. The cliff top trails continues East and West to Flogan Shames and Vindel Frowns, Dofsan Vex is to the Northwest, a dark cave Northeast leasts to Simean Dims.

>nw
Dofsan Vex
You are in the lovely wide open fields of Dofsan Vex, Alakol. Carrying on North takes you to Isalan Interval, meanwhile the coastal path to the Southeast and Southwest head off to Taftan Raves and Vindel Frowns. A dark cave entrance to the East leads to Simean Dims.

You can see an Alchemical Goods Vendor, a shrine to Tii (empty), a dirt pile, two Fruit Trees, a Wood Tree and a Bubble Tree here.

>x shrine
A shrine dedicated to a certain giant. All donations deposited into such a shrine will, through the gigantic grapevine, result in favour being paid to the donator. Shrines to the 11 Giants can be found throughout Ur.

>get shrine
That's fixed in place.

>get tree
Which do you mean, a Fruit Tree, the Wood Tree or the Bubble Tree?

>get fruit tree
That's fixed in place.

>x dirt pile
A pile of dirt. Digging it with a shovel produces various dirty rewards, their quality depending on how deeply you appreciate soil, and how many friends are digging with you.

* * *

>w
Ekorran Roughs
You are in Ekorran Roughs, Alakol. The clifftop trails lead off East and West to Anrasan Glance and Flogan Shames, Lustan Cautions is Northwest, a cave entrance to the North leads to Getan Tenets while a path down the cliff to the South leads to beach and Via Firozi.

You can see a Kitchen Tools Vendor, a shrine to Grendaline (empty), a Dirt Pile, a Fruit Tree, five Metal Rocks, two Dullite Rocks and three Beryl Rocks here.

>ne
Getan Tenets
You are in the underground cave of Getan Tenets. You can exit to Anrasan Glance and Ekorran Roughs through a cave exit Southeast and Southwest. Other exits to the Northeast and West will take you to Stora Rede and Lustan Cautions.

You can see an Alchemical Goods Vendor, a shrine to Friendly (empty), an Egg Plant, nine Metal Rocks and four Beryl Rocks here.

>sw
Ekorran Roughs
You are in Ekorran Roughs, Alakol. The clifftop trails lead off East and West to Anrasan Glance and Flogan Shames, Lustan Cautions is Northwest, a cave entrance to the North leads to Getan Tenets while a path down the cliff to the South leads to beach and Via Firozi.

You can see a Kitchen Tools Vendor, a shrine to Grendaline (empty), a Dirt Pile, a Fruit Tree, five Metal Rocks, two Dullite Rocks and three Beryl Rocks here.

>nw
Lustan Cautions
You are in Lustan Cautions, Alakol. There's a deep dark cave Northeast heading into Getan Tenets, the cliff top trails can be seen to the Southeast and Southwest leading to Ekorran Roughs and Flogan Shames. The main track leads North to Stora Rede, while a small nearly hidden grassy path wanders West to Rekan Flux.

You can see a Groceries Vendor, a shrine to Pot (empty), a Gas Plant and two Fruit Trees here.

>x plant
The ever-mellow Gas Plant. Packed with a stash of General Vapour that's just begging to be gassified. With a love of the murky and mystical, Gas Plants can often be found in totally far out spaces.

>x vendor
Carrying the kind of ingredients necessary for some of your more fancy-pant meals, this Pot-endorsed Street Spirit sells anything delicious that you cannot make at home (like honey, birch syrup and salmon) and a couple of things you can (like buns and garlic). Grocery Street Spirits: The Foodie's Friend.

* * *

>w
Ekorran Roughs
You are in Ekorran Roughs, Alakol. The clifftop trails lead off East and West to Anrasan Glance and Flogan Shames, Lustan Cautions is Northwest, a cave entrance to the North leads to Getan Tenets while a path down the cliff to the South leads to beach and Via Firozi.

You can see a Kitchen Tools Vendor, a shrine to Grendaline (empty), a Dirt Pile, a Fruit Tree, five Metal Rocks, two Dullite Rocks and three Beryl Rocks here.

>w
Flogan Shames
You are in Flogan Shames, Alakol. The cliff top trails lead off East and West to Ekorran Roughs and Taftan Raves, Lustan Cautions is to the Northeast, a dark cave Northwest leasts to Simean Dims.

You can see a Gardening Goods Vendor, a shrine to Spriggan (empty), a Patch, five Metal Rocks, three Beryl Rocks and four Dullite Rocks here.

>x vendor
Endorsed by Mab herself, if you find a Street Spirit specialising in Gardening Goods, you'll find everything necessary for home-grown self-sufficiency.

>x shrine
A shrine dedicated to a certain giant. All donations deposited into such a shrine will, through the gigantic grapevine, result in favour being paid to the donator. Shrines to the 11 Giants can be found throughout Ur.

>x patch
A humble, weedy patch. With a spade you can dig it, a hoe you can tend it, and, with a bean, even grow a tree in it. (NB: Trees are delicate organisms, and beans will only consent to being planted in the correct region.)

>x metal
A stupefying combination of classic rock and the power of metal. Most often found in rocky areas, these heavyweights are indispensable in the production of ingots and the metallurgic arts.

>x beryl
A mineral dull in colour if not composite, Beryl can generally be found underground, where its eerie green surface calls to miners, refiners and gem collectors alike.

>x dullite
A study in shades of grey, gray, and a monochromatic 8-bit scale of debatable spelling, this common rock is mostly found underground, is minable, and may contain precious gems.

>get all
There are none at all available!

>take all
There are none at all available!

>get tree
You can't see any such thing.

>get vendor
I don't suppose the Gardening Goods Vendor would care for that.

>get metal rocks
There are none at all available!

>get patch
That's fixed in place.

>get four dullite rocks
You can't see any such thing.

>x rocks
You can't use multiple objects with that verb.

>x rock
Which do you mean, a Metal Rock, a Beryl Rock or a Dullite Rock?

>get rock
Which do you mean, a Metal Rock, a Beryl Rock or a Dullite Rock?

>get dullite rock
That's fixed in place.

>get all rocks
There are none at all available!

>get all metal rocks
There are none at all available!

* * *

>w
Flogan Shames
You are in Flogan Shames, Alakol. The cliff top trails lead off East and West to Ekorran Roughs and Taftan Raves, Lustan Cautions is to the Northeast, a dark cave Northwest leasts to Simean Dims.

You can see a Gardening Goods Vendor, a shrine to Spriggan (empty), a Patch, five Metal Rocks, three Beryl Rocks and four Dullite Rocks here.

>nw
Simean Dims
Ooooh, you are underground in Simean Dims, Alakol, how exciting! There are several exits out of this cave, but it's so snug and warm why would you want to leave?

>n
Isalan Interval
You are in Isalan Interval, Alakol. Paths Southwest and Northwest head to Dofsan Vex and Jadraan Fix, while a small trail leads Northeast to the base of Feman Falters. A small dark cave to the Southeast is the way to enter Simean Dims. The smell of damp foxes drifts over from the Gimja Preserve to the East.

You can see a Gardening Goods Vendor, a shrine to Grendaline (empty), a Dirt Pile, two Bean Trees and a Fruit Tree here.

>nw
Jadraan Fix
You are in Jadraan Fix, Alakol. A pretty looking walk heads Southwest and West to Marlan Bias and Stopan Winnow, Southeast takes you to Isalan Interval while a stoney path East leads to the base of Feman Falters.

You can see a Hardware Vendor, a shrine to Alph (empty), a Bean Tree and two Fruit Trees here.

>x vendor
Clanking almost inaudibly as it bounces gently up and down, you might think the Street Spirit specialising Hardware doesn't look like a vendor carrying several tonnes of equipment, but you would be wrong. Bags, Toolboxes, Gassifiers, Fruit-changers and Machine Parts can all be found tucked into invisible pockets of the Alph-endorsed Street Spirit. If you can use it to turn one thing into another, the Hardware vendor probably has it.

* * *

>w
Flogan Shames
You are in Flogan Shames, Alakol. The cliff top trails lead off East and West to Ekorran Roughs and Taftan Raves, Lustan Cautions is to the Northeast, a dark cave Northwest leasts to Simean Dims.

You can see a Gardening Goods Vendor, a shrine to Spriggan (empty), a Patch, five Metal Rocks, three Beryl Rocks and four Dullite Rocks here.

>w
Taftan Raves
You are in Taftan Raves, Alakol. The cliff top trails continues East and West to Flogan Shames and Vindel Frowns, Dofsan Vex is to the Northwest, a dark cave Northeast leasts to Simean Dims.

>w
Vindel Frowns
You are in Vindel Frowns, Alakol. The cliff top trails continues East and Northwest to Taftan Raves and Hammar Steadies. You can also leave the clift top path by going North or Northeast.

>w
You can't go that way.

>nw
Hammar Steadies
You are in Hammar Steadies, Alakol. The clifftop trails lead off North and Southeast to Smy Mod and Vindel Frowns, grassy paths head Northeast to Dyran Notion and East to Navran Dissent.

You can see a Groceries Vendor, a shrine to Cosma (empty), a Bean Tree, three Metal Rocks and three Dullite Rocks here.

>x vendor
Carrying the kind of ingredients necessary for some of your more fancy-pant meals, this Pot-endorsed Street Spirit sells anything delicious that you cannot make at home (like honey, birch syrup and salmon) and a couple of things you can (like buns and garlic). Grocery Street Spirits: The Foodie's Friend.

>x spirit
You can't see any such thing.

>x sprite
You can't see any such thing.

>x street sprite
You can't see any such thing.

>x street sprite
You can't see any such thing.

>x vendor
Carrying the kind of ingredients necessary for some of your more fancy-pant meals, this Pot-endorsed Street Spirit sells anything delicious that you cannot make at home (like honey, birch syrup and salmon) and a couple of things you can (like buns and garlic). Grocery Street Spirits: The Foodie's Friend.

* * *

>w
Vindel Frowns
You are in Vindel Frowns, Alakol. The cliff top trails continues East and Northwest to Taftan Raves and Hammar Steadies. You can also leave the clift top path by going North or Northeast.

>n
Dofsan Vex
You are in the lovely wide open fields of Dofsan Vex, Alakol. Carrying on North takes you to Isalan Interval, meanwhile the coastal path to the Southeast and Southwest head off to Taftan Raves and Vindel Frowns. A dark cave entrance to the East leads to Simean Dims.

You can see an Alchemical Goods Vendor, a shrine to Tii (empty), a Dirt Pile, two Fruit Trees, a Wood Tree and a Bubble Tree here.

>s
Vindel Frowns
You are in Vindel Frowns, Alakol. The cliff top trails continues East and Northwest to Taftan Raves and Hammar Steadies. You can also leave the clift top path by going North or Northeast.

>ne
Navran Dissent
You are in Navran Dissent, Alakol. Cliff top trails can be seen to the South and Southwest leading to Vindel Frowns and Hammar Steadies. There are also paths leading off at slight angles to each other North and Northwest.

>se
You can't go that way.

>s
Vindel Frowns
You are in Vindel Frowns, Alakol. The cliff top trails continues East and Northwest to Taftan Raves and Hammar Steadies. You can also leave the clift top path by going North or Northeast.

>n
Dofsan Vex
You are in the lovely wide open fields of Dofsan Vex, Alakol. Carrying on North takes you to Isalan Interval, meanwhile the coastal path to the Southeast and Southwest head off to Taftan Raves and Vindel Frowns. A dark cave entrance to the East leads to Simean Dims.

You can see an Alchemical Goods Vendor, a shrine to Tii (empty), a Dirt Pile, two Fruit Trees, a Wood Tree and a Bubble Tree here.

* * *

>ne
Navran Dissent
You are in Navran Dissent, Alakol. Cliff top trails can be seen to the South and Southwest leading to Vindel Frowns and Hammar Steadies. There are also paths leading off at slight angles to each other North and Northwest.

>s
Vindel Frowns
You are in Vindel Frowns, Alakol. The cliff top trails continues East and Northwest to Taftan Raves and Hammar Steadies. You can also leave the clift top path by going North or Northeast.

>nw
Hammar Steadies
You are in Hammar Steadies, Alakol. The clifftop trails lead off North and Southeast to Smy Mod and Vindel Frowns, grassy paths head Northeast to Dyran Notion and East to Navran Dissent.

You can see a Groceries Vendor, a shrine to Cosma (empty), a Bean Tree, three Metal Rocks and three Dullite Rocks here.

>s
You can't go that way.

>nw
You can't go that way.

>se
Vindel Frowns
You are in Vindel Frowns, Alakol. The cliff top trails continues East and Northwest to Taftan Raves and Hammar Steadies. You can also leave the clift top path by going North or Northeast.

>n
Dofsan Vex
You are in the lovely wide open fields of Dofsan Vex, Alakol. Carrying on North takes you to Isalan Interval, meanwhile the coastal path to the Southeast and Southwest head off to Taftan Raves and Vindel Frowns. A dark cave entrance to the East leads to Simean Dims.

You can see an Alchemical Goods Vendor, a shrine to Tii (empty), a Dirt Pile, two Fruit Trees, a Wood Tree and a Bubble Tree here.

* * *

>w
Vindel Frowns
You are in Vindel Frowns, Alakol. The cliff top trails continues East and Northwest to Taftan Raves and Hammar Steadies. You can also leave the clift top path by going North or Northeast.

>nw
Hammar Steadies
You are in Hammar Steadies, Alakol. The clifftop trails lead off North and Southeast to Smy Mod and Vindel Frowns, grassy paths head Northeast to Dyran Notion and East to Navran Dissent.

>e
Navran Dissent
You are in Navran Dissent, Alakol. Cliff top trails can be seen to the South and Southwest leading to Vindel Frowns and Hammar Steadies. There are also paths leading off at slight angles to each other North and Northwest.

>w
Hammar Steadies
You are in Hammar Steadies, Alakol. The clifftop trails lead off North and Southeast to Smy Mod and Vindel Frowns, grassy paths head Northeast to Dyran Notion and East to Navran Dissent.

>ne
Dyran Notion
You are in Dyran Notion, Alakol. Marlan Bias and Navran Dissent are futher into the grassy plains to the North and Southeast, while Hammar Steadies and Smy Mod are along a rock path running Southwest and Westwards.

You can see a Produce Vendor, a shrine to Mab (empty) and four Fruit Trees here.

>x vendor
For chefs, saucerers and fry-cooks who love to cook but hate to garden, a Street Spirit selling Produce specialises in providing any vegetable you might require for a recipe. Sure, you could grow tomatoes, potatoes, cucumbers or corn in a garden - but why bother, when you could procure them right here in the Produce Aisle.

>x shrine
A shrine dedicated to a certain giant. All donations deposited into such a shrine will, through the gigantic grapevine, result in favour being paid to the donator. Shrines to the 11 Giants can be found throughout Ur.

>x
What do you want to examine?

>tree
compass (5) 
  the north
  the northeast
  the northwest
  the south
  the southeast
  the southwest
  the east
  the west
  the up
  the down
  the inside
  the outside
(LibraryMessages) (6) 
(darkness object) (7) 
(Inform Parser) (8) 
(Inform Library) (9) 
(property_numberspace_forcer) (10) 
(ValuePropertyHolder_39) (12) 
Alakol (99) 
Andra (100) 
Aranna (101) 
Balzare (102) 
Baqala (103) 
Besara (104) 
Bortola (105) 
Brillah (106) 
Callopee (107) 
Cauda (108) 
Chakra Phool (109) 
Choru (110) 
Drifa (111) 
Fenneq (112) 
Firozi (113) 
Folivoria (114) 
Groddle Forest (115) 
Groddle Heights (116) 
Groddle Meadow (117) 
Haoma (118) 
Haraiva (119) 
Ilmenskie Caverns (120) 
Ilmenskie Deeps (121) 
Ix (122) 
Jal (123) 
Jethimadh (124) 
Kajuu (125) 
Kalavana (126) 
Karnata (127) 
Kloro (128) 
Lida (129) 
Massadoe (130) 
Moshi Moshi Oshilatis (131) 
Muufo (132) 
Nottis (133) 
Ormonos (134) 
Pollokoo (135) 
Rasana (136) 
Roobrik (137) 
Salatu (138) 
Samudra (139) 
Shimla Mirch (140) 
Sura (141) 
Tahli (142) 
Tamila (143) 
Uralia (144) 
Vantalu (145) 
Vortex of Random (146) 
Xalanga (147) 
Zhambu (148) 
Anrasan Glance (149) 
  a Produce Vendor
  a shrine to Mab
  a Fruit Tree
  a Bean Tree
  nine metal rocks
  four dullite rocks
Ekorran Roughs (167) 
Getan Tenets (168) 
Semsan Simile (169) 
Bolesan Ambitions (170) 
  a Produce Vendor
  a shrine to Spriggan
  two metal rocks
  three sparkly rocks
Motala Dun (178) 
Harkan Idiom (179) 
Pinnan Glimpse (180) 
Yan Jaggery (181) 
Brunnan Bafflings (182) 
  three beryl rocks
  a Toy Vendor
  a shrine to Cosma
  two Bean Trees
  three metal rocks
Feman Falters (191) 
Fyran Descant (192) 
Ojan Repine (193) 
Dofsan Vex (194) 
  an Alchemical Goods Vendor
  a shrine to Tii
  a dirt pile
  two Fruit Trees
  a Wood Tree
  a Bubble Tree
Isalan Interval (202) 
Simean Dims (203) 
Taftan Raves (204) 
Vindel Frowns (205) 
Dyran Notion (206) 
  yourself
  a Produce Vendor
  a shrine to Mab
  four Fruit Trees
Marlan Bias (213) 
Navran Dissent (214) 
Hammar Steadies (215) 
Smy Mod (216) 
Via Firozi (217) 
Flogan Shames (218) 
Lustan Cautions (219) 
Idan Frisk (220) 
Torpan Cleft (221) 
Jadraan Fix (222) 
Stora Rede (223) 
Gimja Preserve (224) 
Kolan Presence (225) 
Stopan Winnow (226) 
Kobah Habitat (227) 
Rekan Flux (228) 
Vragan Boost (229) 
Onbo Park (230)

>x
What do you want to examine?

>x tree
The glorious Fruit Tree. Thick with tasty cherries ripe to be converted into other delicious fruits, these venerable plants may not be chatty, but they're indispensable for fine edibles and quaffables of all sorts.

>tree
compass (5) 
  the north
  the northeast
  the northwest
  the south
  the southeast
  the southwest
  the east
  the west
  the up
  the down
  the inside
  the outside
(LibraryMessages) (6) 
(darkness object) (7) 
(Inform Parser) (8) 
(Inform Library) (9) 
(property_numberspace_forcer) (10) 
(ValuePropertyHolder_39) (12) 
Alakol (99) 
Andra (100) 
Aranna (101) 
Balzare (102) 
Baqala (103) 
Besara (104) 
Bortola (105) 
Brillah (106) 
Callopee (107) 
Cauda (108) 
Chakra Phool (109) 
Choru (110) 
Drifa (111) 
Fenneq (112) 
Firozi (113) 
Folivoria (114) 
Groddle Forest (115) 
Groddle Heights (116) 
Groddle Meadow (117) 
Haoma (118) 
Haraiva (119) 
Ilmenskie Caverns (120) 
Ilmenskie Deeps (121) 
Ix (122) 
Jal (123) 
Jethimadh (124) 
Kajuu (125) 
Kalavana (126) 
Karnata (127) 
Kloro (128) 
Lida (129) 
Massadoe (130) 
Moshi Moshi Oshilatis (131) 
Muufo (132) 
Nottis (133) 
Ormonos (134) 
Pollokoo (135) 
Rasana (136) 
Roobrik (137) 
Salatu (138) 
Samudra (139) 
Shimla Mirch (140) 
Sura (141) 
Tahli (142) 
Tamila (143) 
Uralia (144) 
Vantalu (145) 
Vortex of Random (146) 
Xalanga (147) 
Zhambu (148) 
Anrasan Glance (149) 
  a Produce Vendor
  a shrine to Mab
  a Fruit Tree
  a Bean Tree
  nine metal rocks
  four dullite rocks
Ekorran Roughs (167) 
Getan Tenets (168) 
Semsan Simile (169) 
Bolesan Ambitions (170) 
  a Produce Vendor
  a shrine to Spriggan
  two metal rocks
  three sparkly rocks
Motala Dun (178) 
Harkan Idiom (179) 
Pinnan Glimpse (180) 
Yan Jaggery (181) 
Brunnan Bafflings (182) 
  three beryl rocks
  a Toy Vendor
  a shrine to Cosma
  two Bean Trees
  three metal rocks
Feman Falters (191) 
Fyran Descant (192) 
Ojan Repine (193) 
Dofsan Vex (194) 
  an Alchemical Goods Vendor
  a shrine to Tii
  a dirt pile
  two Fruit Trees
  a Wood Tree
  a Bubble Tree
Isalan Interval (202) 
Simean Dims (203) 
Taftan Raves (204) 
Vindel Frowns (205) 
Dyran Notion (206) 
  yourself
  a Produce Vendor
  a shrine to Mab
  four Fruit Trees
Marlan Bias (213) 
Navran Dissent (214) 
Hammar Steadies (215) 
Smy Mod (216) 
Via Firozi (217) 
Flogan Shames (218) 
Lustan Cautions (219) 
Idan Frisk (220) 
Torpan Cleft (221) 
Jadraan Fix (222) 
Stora Rede (223) 
Gimja Preserve (224) 
Kolan Presence (225) 
Stopan Winnow (226) 
Kobah Habitat (227) 
Rekan Flux (228) 
Vragan Boost (229) 
Onbo Park (230)

>x tree
The glorious Fruit Tree. Thick with tasty cherries ripe to be converted into other delicious fruits, these venerable plants may not be chatty, but they're indispensable for fine edibles and quaffables of all sorts.

* * *

>w
Vindel Frowns
You are in Vindel Frowns, Alakol. The cliff top trails continues East and Northwest to Taftan Raves and Hammar Steadies. You can also leave the clift top path by going North or Northeast.

>ne
Dofsan Vex
You are in the lovely wide open fields of Dofsan Vex, Alakol. Carrying on North takes you to Isalan Interval, meanwhile the coastal path to the Southeast and Southwest head off to Taftan Raves and Vindel Frowns. A dark cave entrance to the East leads to Simean Dims.

You can see an Alchemical Goods Vendor, a shrine to Tii (empty), a Dirt Pile, two Fruit Trees, a Wood Tree and a Bubble Tree here.

>sw
Vindel Frowns
You are in Vindel Frowns, Alakol. The cliff top trails continues East and Northwest to Taftan Raves and Hammar Steadies. You can also leave the clift top path by going North or Northeast.

>n
Navran Dissent
You are in Navran Dissent, Alakol. Cliff top trails can be seen to the South and Southwest leading to Vindel Frowns and Hammar Steadies. There are also paths leading off at slight angles to each other North and Northwest.

>s
Vindel Frowns
You are in Vindel Frowns, Alakol. The cliff top trails continues East and Northwest to Taftan Raves and Hammar Steadies. You can also leave the clift top path by going North or Northeast.

* * *

>nw
Hammar Steadies
You are in Hammar Steadies, Alakol. The clifftop trails lead off North and Southeast to Smy Mod and Vindel Frowns, grassy paths head Northeast to Dyran Notion and East to Navran Dissent.

You can see a Groceries Vendor, a shrine to Cosma (empty), a Bean Tree, three Metal Rocks and three Dullite Rocks here.

>se
Vindel Frowns
You are in Vindel Frowns, Alakol. The cliff top trails continues East and Northwest to Taftan Raves and Hammar Steadies. You can also leave the clift top path by going North or Northeast.

>n
Navran Dissent
You are in Navran Dissent, Alakol. Cliff top trails can be seen to the South and Southwest leading to Vindel Frowns and Hammar Steadies. There are also paths leading off at slight angles to each other North and Northwest.

>n
Marlan Bias
You are in Marlan Bias, Alakol. You can make out winding tracks leading Northwest, Northeast, Southwest and South.

You can see an Alchemical Goods Vendor, a shrine to Friendly (empty), a Dirt Pile and two Gas Plants here.

>x vendor
Fizzling and clinking gently as it bobs up and down, this street spirit (endorsed by all-powerful Tii), is a one-stop shop for all your alchemical needs. From Tongs to Tincturing Kits, Fancy Picks to Firefly Jars, you'll find everything Alchemy, Crystalmalizing and Potion-related right here.

>x gas plant
The ever-mellow Gas Plant. Packed with a stash of General Vapour that's just begging to be gassified. With a love of the murky and mystical, Gas Plants can often be found in totally far out spaces.

* * *

>w
Taftan Raves
You are in Taftan Raves, Alakol. The cliff top trails continues East and West to Flogan Shames and Vindel Frowns, Dofsan Vex is to the Northwest, a dark cave Northeast leasts to Simean Dims.

>nw
Dofsan Vex
You are in the lovely wide open fields of Dofsan Vex, Alakol. Carrying on North takes you to Isalan Interval, meanwhile the coastal path to the Southeast and Southwest head off to Taftan Raves and Vindel Frowns. A dark cave entrance to the East leads to Simean Dims.

You can see a shrine to Ti, a dirt pile, an Alchemical Goods Vendor, two Fruit Trees, a Wood Tree and a Bubble Tree here.

>x vendor
Fizzling and clinking gently as it bobs up and down, this street spirit (endorsed by all-powerful Tii), is a one-stop shop for all your alchemical needs. From Tongs to Tincturing Kits, Fancy Picks to Firefly Jars, you'll find everything Alchemy, Crystalmalizing and Potion-related right here.

>x fruit tree
The glorious Fruit Tree. Thick with tasty cherries ripe to be converted into other delicious fruits, these venerable plants may not be chatty, but they're indispensable for fine edibles and quaffables of all sorts.

>x wood tree
While all trees are woody, the Wood Tree is woodier than most. Tending to your wood is a rewarding solitary pursuit, but gathering friends to engorge your wood before all wielding your choppers simultaneously is both mutually satisfying, and sure to result in the injection of firm, tasty planks into your bag.

>x bubble tree
The delicate Bubble Tree. Bursting with plain bubbles waiting to be tuned, these somewhat unstable specimens harbor fruit of perfect transparency - and thoughts of bizarre conspiracy.

>x shrine
You see nothing special about the shrine to Ti.

* * *

>w
Ekorran Roughs
You are in Ekorran Roughs, Alakol. The clifftop trails lead off East and West to Anrasan Glance and Flogan Shames, Lustan Cautions is Northwest, a cave entrance to the North leads to Getan Tenets while a path down the cliff to the South leads to beach and Via Firozi.

You can see a Kitchen Tools Vendor, a shrine to Grendaline (empty), a Dirt Pile, a Fruit Tree, five Metal Rocks, two Dullite Rocks and three Beryl Rocks here.

>nw
Lustan Cautions
You are in Lustan Cautions, Alakol. There's a deep dark cave Northeast heading into Getan Tenets, the cliff top trails can be seen to the Southeast and Southwest leading to Ekorran Roughs and Flogan Shames. The main track leads North to Stora Rede, while a small nearly hidden grassy path wanders West to Rekan Flux.

>w
Rekan Flux
You are in pleasent fields of Rekan Flux, Alakol. There are clear exists East and West, while a short path curves round North to Ojan Repine.

>ne
You can't go that way.

>n
Ojan Repine
You are in Ojan Repine, Alakol. A tricky looking path leads Northeast and North to the base of the cliff at Fyran Descant and Brunnan Bafflings, meanwhile an easier looking path winds off Southwest and Southeast.

>n
Brunnan Bafflings
You are in Brunnan Bafflings, Alakol. It's a grim cliff face strewn with rocks, along the bottom you can get to Fyran Descant Southeast and Ojan Repine South. There is a small pass to the North that takes you to Feman Falters.

You can see three beryl rocks, a Toy Vendor, a shrine to Cosma (empty), two Bean Trees and three metal rocks here.

>exam venfor
That's not a verb I recognise.

>exam vendor
That's not a verb I recognise.

>x vendor
Once branded in the age of Tii as The Lord of Misrule, this is a bit unfair for a street spirit who, let's face it, mainly specialises in selling dice, party spaces, cubimals, cameras and other things that are fun. If you like fun, seek out a Street Spirit with Toys. And why wouldn't you? You don't want everyone to think you hate FUN, do you?

* * *

>w
Ekorran Roughs
You are in Ekorran Roughs, Alakol. The clifftop trails lead off East and West to Anrasan Glance and Flogan Shames, Lustan Cautions is Northwest, a cave entrance to the North leads to Getan Tenets while a path down the cliff to the South leads to beach and Via Firozi.

You can see a Kitchen Tools Vendor, a shrine to Grendaline (empty), a Dirt Pile, a Fruit Tree, five Metal Rocks, two Dullite Rocks and three Beryl Rocks here.

>x vendor
You can't make an omlet without making eggs might be true, but you'd look pretty stupid trying to make one without a frying pan as well. If you need a Frying Pan for frying, a Saucepan for saucing, or an Awesome Pot for general awesomeness, you need to look to the Street Spirit who holds all the Kitchen Tools.

>x shrine
A shrine dedicated to a certain giant. All donations deposited into such a shrine will, through the gigantic grapevine, result in favour being paid to the donator. Shrines to the 11 Giants can be found throughout Ur.

>x pile
A pile of dirt. Digging it with a shovel produces various dirty rewards, their quality depending on how deeply you appreciate soil, and how many friends are digging with you.

>x rocks
You can't use multiple objects with that verb.

>x rock
Which do you mean, a metal rock, a dullite rock or a beryl rock?

>x metal rock
A stupefying combination of classic rock and the power of metal. Most often found in rocky areas, these heavyweights are indispensable in the production of ingots and the metallurgic arts.

>x beryl rock
A mineral dull in colour if not composite, Beryl can generally be found underground, where its eerie green surface calls to miners, refiners and gem collectors alike.

* * *

>nw
Getan Tenets
You are in the underground cave of Getan Tenets. You can exit to Anrasan Glance and Ekorran Roughs through a cave exit Southeast and Southwest. Other exits to the Northeast and West will take you to Stora Rede and Lustan Cautions.

You can see an Alchemical Goods Vendor, a shrine to Friendly (empty), an Egg Plant, nine Metal Rocks and four Beryl Rocks here.

>n
You can't go that way.

>ne
Stora Rede
You are in Stora Rede, Alakol. A rocky path leads to Yan Jaggery and Torpan Cleft to the Northeast and North, while in the opposite direction a grassy track heads South into the Lustan Cautions. Curiously the faint sound of foxes can be heard drifting in from the East.

Oh and cave! There's a cave to the Southeast.

>e
Kobah Habitat
You are in Kobah Habitat, a premier Fox Brushing Preserve in Alakol. Sometimes, rarely, you can see a fox in much need of a brushing here. The only way out of the preserve is back West.

>w
Stora Rede
You are in Stora Rede, Alakol. A rocky path leads to Yan Jaggery and Torpan Cleft to the Northeast and North, while in the opposite direction a grassy track heads South into the Lustan Cautions. Curiously the faint sound of foxes can be heard drifting in from the East.

Oh and cave! There's a cave to the Southeast.

>ne
Yan Jaggery
You are in Yan Jaggery, Alakol. Its a bit windy up here but comes with fansatic views South across Alakol. Exits are all over the place but for the sake of simplicity; North, East, Northwest and Southwest.

>n
Bolesan Ambitions
You are in Bolesan Ambitions, Alakol. A cave entrance leads the way Northeast to Motala Dun, while a rocky path leads Northwest to Harkan Idiom. Pinnan Glimpse is Southeast and Yan Jaggery is South.

You can see a Produce Vendor, a shrine to Spriggan (empty), two Metal Rocks and three Sparkly Rocks here.

>nw
Harkan Idiom
You are high up in the mountains in Harkan Idiom, Alakol. Rocky trails lead Northwest, Southwest and Southeast to Kolan Presence, Idan Fris and Bolesan Ambitions. To the East a cave mouth acts as the entrance to Motala Dun.

You can see an Alchemical Goods Vendor, a shrine to Tii (empty), a Patch, a Wood Tree, two Fruit Trees, a Dullite Rock and two Metal Rocks here.

>x tii
A shrine dedicated to a certain giant. All donations deposited into such a shrine will, through the gigantic grapevine, result in favour being paid to the donator. Shrines to the 11 Giants can be found throughout Ur.

>x vendor
Fizzling and clinking gently as it bobs up and down, this street spirit (endorsed by all-powerful Tii), is a one-stop shop for all your alchemical needs. From Tongs to Tincturing Kits, Fancy Picks to Firefly Jars, you'll find everything Alchemy, Crystalmalizing and Potion-related right here.

>x patch
A humble, weedy patch. With a spade you can dig it, a hoe you can tend it, and, with a bean, even grow a tree in it. (NB: Trees are delicate organisms, and beans will only consent to being planted in the correct region.)

>x tree
Which do you mean, the Wood Tree or a Fruit Tree?

>x dullite
A study in shades of grey, gray, and a monochromatic 8-bit scale of debatable spelling, this common rock is mostly found underground, is minable, and may contain precious gems.

>x metal
A stupefying combination of classic rock and the power of metal. Most often found in rocky areas, these heavyweights are indispensable in the production of ingots and the metallurgic arts.

* * *

>ne
Stora Rede
You are in Stora Rede, Alakol. A rocky path leads to Yan Jaggery and Torpan Cleft to the Northeast and North, while in the opposite direction a grassy track heads South into the Lustan Cautions. Curiously the faint sound of foxes can be heard drifting in from the East.

Oh and cave! There's a cave to the Southeast.

>nw
You can't go that way.

>n
Torpan Cleft
You are in Torpan Cleft, Alakol. You can see the entrance to Torpan Cleft Subway Station here, which irritatingly you can't get into. Exists you can get into are Northeast, Southeast, South, West and Northwest.

>w
Fyran Descant
You are in Fyran Descant, Alakol. A steep climb to the East leads to the Torpan Cleft, meanwhile a grassy trail leads West and Southwest to Brunnan Bafflings and Ojan Repine.

You can see a Gardening Goods Vendor, a shrine to Spriggan (empty), a Bean Tree, a Sparkly Rock, a Dullite Rock, three Metal Rocks and two Beryl Rocks here.

>x vendor
Endorsed by Mab herself, if you find a Street Spirit specialising in Gardening Goods, you'll find everything necessary for home-grown self-sufficiency.

* * *

>x shrine
A shrine dedicated to a certain giant. All donations deposited into such a shrine will, through the gigantic grapevine, result in favour being paid to the donator. Shrines to the 11 Giants can be found throughout Ur.

>x bean tree
The good old Tree of Bean. Laden with 57 varieties of identical-looking legume, these protein-machines provide the raw ingredients for hearty chow and base material for new trees.

>get beryl rock
That's fixed in place.

>get beryl rocks
There are none at all available!

>get beryl rock
That's fixed in place.

>get two beryl rock
You can't see any such thing.

>get two beryl rocks
You can't see any such thing.

>get 2 beryl rocks
You can't see any such thing.

>get 2 beryl rock
You can't see any such thing.

* * *

>n
Torpan Cleft
You are in Torpan Cleft, Alakol. You can see the entrance to Torpan Cleft Subway Station here, which irritatingly you can't get into. Exists you can get into are Northeast, Southeast, South, West and Northwest.

>nw
Feman Falters
You are in Feman Falters, Alakol. Paths heading East and Southeast at the top of the rocky cliff face take you to Idan Frisk and Torpan Cleft, while a trail at the bottom leads South to Brunnan Bafflings. Isalan Interval is Southwest and Jadraan Fix is West.

You can see a Produce Vendor, a shrine to Mab (empty), a Bean Tree, a Sparkly Rock, two Beryl Rocks and two Metal Rocks here.

>x vendor
For chefs, saucerers and fry-cooks who love to cook but hate to garden, a Street Spirit selling Produce specialises in providing any vegetable you might require for a recipe. Sure, you could grow tomatoes, potatoes, cucumbers or corn in a garden - but why bother, when you could procure them right here in the Produce Aisle.

* * *

>x bean tree
The good old Tree of Bean. Laden with 57 varieties of identical-looking legume, these protein-machines provide the raw ingredients for hearty chow and base material for new trees.

>x sparkly
The most desperate-to-be-loved mineral you could ever hope to meet, this minable mini-mountain brings a touch of disco to out-of-the-way places. Full of high-value chunks and crushable minerals, every major miner seeks their own vein of sparkly.

>x metal
A stupefying combination of classic rock and the power of metal. Most often found in rocky areas, these heavyweights are indispensable in the production of ingots and the metallurgic arts.

* * *

>nw
Getan Tenets
You are in the underground cave of Getan Tenets. You can exit to Anrasan Glance and Ekorran Roughs through a cave exit Southeast and Southwest. Other exits to the Northeast and West will take you to Stora Rede and Lustan Cautions.

You can see an Alchemical Goods Vendor, a shrine to Friendly (empty), an Egg Plant, nine Metal Rocks and four Beryl Rocks here.

>nw
Stora Rede
You are in Stora Rede, Alakol.

>se
Getan Tenets
You are in Getan Tenets, Alakol.

>nw
Getan Tenets
You are in Getan Tenets, Alakol.

>e
You can't go that way.

>se
Anrasan Glance
You are in Anrasan Glance, Alakol. Ekorran Roughs is to the West, Getan Tenets is Northwest and Semsan Simile is East.

You can see a Produce Vendor, a shrine to Mab (empty), a Fruit Tree, a Bean Tree, nine metal rocks and four dullite rocks here.

>nw
Getan Tenets
You are in Getan Tenets, Alakol.

>n
You can't go that way.

>se
Anrasan Glance
You are in Anrasan Glance, Alakol. Ekorran Roughs is to the West, Getan Tenets is Northwest and Semsan Simile is East.

You can see a Produce Vendor, a shrine to Mab (empty), a Fruit Tree, a Bean Tree, nine metal rocks and four dullite rocks here.

>w
Ekorran Roughs
You are in Ekorran Roughs, Alakol.

>ne
Getan Tenets
You are in Getan Tenets, Alakol.

>sw
Ekorran Roughs
You are in Ekorran Roughs, Alakol.

>w
Flogan Shames
You are in Flogan Shames, Alakol.

>back
That's not a verb I recognise.

>go back
You can't see any such thing.

>go north
You can't go that way.

>e
Ekorran Roughs
You are in Ekorran Roughs, Alakol.

>go west
Flogan Shames
You are in Flogan Shames, Alakol.

* * *

>nw
Getan Tenets
You are in the underground cave of Getan Tenets. You can exit to Anrasan Glance and Ekorran Roughs through a cave exit Southeast and Southwest. Other exits to the Northeast and West will take you to Stora Rede and Lustan Cautions.

You can see an Alchemical Goods Vendor, a shrine to Friendly (empty), an Egg Plant, nine Metal Rocks and four Beryl Rocks here.

>x vendor
Fizzling and clinking gently as it bobs up and down, this street spirit (endorsed by all-powerful Tii), is a one-stop shop for all your alchemical needs. From Tongs to Tincturing Kits, Fancy Picks to Firefly Jars, you'll find everything Alchemy, Crystalmalizing and Potion-related right here.

>x shrine
A shrine dedicated to a certain giant. All donations deposited into such a shrine will, through the gigantic grapevine, result in favour being paid to the donator. Shrines to the 11 Giants can be found throughout Ur.

>x egg plant
The noble Egg Plant. As is fitting to a fruit as ovoidly perfect as a prolate moon, Egg Plants (of course) can only be found underground in cool, dark places.